111111111111111111111111111111111111111
1                                     1
1                                     1 
1                  3                  1
1                                     1
1                                     1
1                                     1
1                                     1
1                                     1
1         222                         1
1         252                         1
1         222                         1
1                                     1
1                                     1
1                                     1
1                                     1
1                                     1
1                                     1
122222222222222222222222222222222222221                                     
122222222222222222222222222222222222221                                     
1                                     1
1                                     1
1                         222         1    
1                         252         1
1                         222         1
1                                     1
1                                     1
1                                     1
1                                     1
1                                     1
1                                     1
1                                     1
1                                     1
1                                     1
1                 4                   1
1                                     1
1                                     1
1                                     1
1                                     1
111111111111111111111111111111111111111