
5ffffffffffffff6
ep0xccc0p0ccw0 e
e e 3f1e e31 e e
e e    e e   epe
e e3f1 e e 31e e
e e    e e   e e
e e 3f1e e31 e e
e e    e e   e e
et23f1 2t2 312 e
e        t     e
4ffffffffffffff7